spin-spun-spun - prząść
spit-spat-spat - pluć
split-split-split - rozszczepiać
spoil-spoiled-spoiled - psuć
spread-spread-spread - rozciągać
spring-sprang-sprung - skakać
stand-stood-stood - stać
steal-stole-stolen - kraść
stick-stuck-stuck - wtykać; kleić
sting-stung-stung - kłuć; żądlić
stink-stank-stunk - śmierdzieć
stride-strode-stridden - kroczyć
strike-struck-struck - uderzać
strive-strove-striven - usiłować; starać się
swear-swore-sworn - przysięgać; kląć
sweep-swept-swept - rozciągać się; zamiatać
swell-swelled-swollen - puchnąć
swim-swam-swum - pływać
swing-swung-swung - kołysać się; huśtać się
take-took-taken - brać
teach-taught-taught - nauczać
tear-tore-torn - rwać
tell-told-told - mówić; opowiadać
think-thought-thought - sądzić; myśleć
throw-threw-thrown - rzucać
thrust-thrust-thrust - pchać
tread-trod-trodden - stąpać
understand-understood-understood - rozumieć
wake-woke-woken - budzić się
wear-wore-worn - mieć ubranym; nosić
weave-wove-woven - tkać
weep-wept-wept - płakać
wet-wetted-wetted - moczyć
win-won-won - wygrywać
wind-wound-wound - nawijać; nakręcać
wring-wrung-wrung - wykręcać
write-wrote-written - pisać
mow-mowed-mown - kosić
pay-paid-paid - płacić
prove-proved-proved; proven - udowadniać
put-put-put - kłaść; położyć
quit-quitted-quitted - opuścić; przestać
read-read-read - czytać
ride-rode-ridden - jeździć (konno, na rowerze itd.)
ring-rang-rung - dzwonić
rise-rose-risen - wstawać
run-ran-run - biec
saw-sawed-sawn - piłować
say-said-said - powiedzieć; mówić
see-saw-seen - widzieć
seek-sought-sought - szukać
sell-sold-sold - sprzedać
send-sent-sent - wysyłać
set-set-set - ustawiać; układać
sew-sewed-sewn - szyć
shake-shook-shaken - trząść
shine-shone-shone - świecić (się)
shoot-shot-shot - strzelać
show-showed-shown - pokazywać
shrink-shrank-shrunk - kurczyć się
shut-shut-shut - zamykać
sing-sang-sung - śpiewać
sink-sank-sunk - tonąć
sit-sat-sat - siedzieć
slay-slew-slain - zabijać
sleep-slept-slept - spać
slide-slid-slid - ślizgać się
smell-smelled-smelled - pachnieć; czuć
sow-sowed-sown - siać
speak-spoke-spoken - mówić
speed-sped-sped - śpieszyć się; mknąć
spell-spelled-spelled - literować
spend-spent-spent - spędzać; wydawać
spill-spilled-spilled - rozlewać